C5C5C5C5C5C5C5C5C5C5C5C5C5C5C5C5C5C5C5C5C5C5C5C5C5C5C50E0E0E0EC5C5C5C5C5
C6C6C6C6C6C6C6C6C6C6C6C6C6C6C6C6C6C6C6C6C6C6C6C6C6C6C60E17170EC6C6C6C6C6
C505050505050505050505050505050505050505050505C50E0EC50E17170EC5C5C5C5C5
C6FFFFFFFFFFFFFFFFFFFFFFFFFFFFFFFFFFFFFFFFFFFFC60E0EC60E0F0E0EC6C6C6C6C6
C5FFFFFFFFFFFFFFFFFFFFFFFFFFFFFFFFFFFFFFFFFFFF050505C50E0E0E0EC50505050E
C6FFFFFFFFFFFFFFFF1EFFFFFFFF1EFFFFFFFFFFFFFFFFFFFFFFC605050505C6FFFFFF06
C5FFFFFFFFFFFFFFFF2EFFFFFF182E19FFFF1AFF5E5FFFFFFFFFC5FFFFFFFFC5FFFFFF06
C6FFFFFFFFFFFFFF000404040404041F1F1F1F1F1F2F2F20BFFFC6FFFFFFFFFFFFFFFF06
C5FFFFFFFFFFFF00C523C5C5C5C5C51E1E1E1E1E1E1E1E1EFFFFFFFFFFFFFFC5FFFFFF06
C66E6F*1FFFF000EC627C6C6C6C6C62E2E2E2E2E2E2E2E2EFFFFFFFF0A0808C612FF12C6
C50404040404C5C5C51717C5C51E1E1EFFFFFFFFFFFFFFFFFFFFFFFFFFFFFFC5FFFFFFC5
C60E0E0E0E0EC6C6C6171DC6C62E2E2EFFFFFFFFFFFFFFFFFFFFFFFFFFFFFFC6FFFFFFC6
C507FFFFFFFFFFFFFFFFFFFFFFFFFFFFFFFFFFFFFFFFFFFFFFFFFF10121212C5FFFFFFC5
C607FFFFFFFFFFFFFFFFFFFFFFFFFFFFFFFFFF0A081414140814141E1E1E201EFFFFFF06
0A0808080808080808080808080808080BFFFF151521210E0E0E0E2E2E2E2B2EFFFFFF06
C6C6C61E4C4D1E1E2F2F1E1E1EFFFFFFFFFFFFFFFFFFFFFFFFFFFFFFFFFF2121FFFFFF06
0E0E0E2E4E4F2E2E2F2F2E2E2EFFFFFFFFFFFFFFFFFFFFFFFFFFFFFFFFFF1521FFFFFF06
0F0F0F0F0F0F0F0F0F0F0F0F0F0F0F0F0F0F0F0F0F0F0F0E0E0E0E0E0E0E0E0E0F0F0F0F